**************************,,***************************,,,*,,,,********************///************/////*////////#%%%&%%%%%%%%%#%%%%###/*****************************************************************
**********************,,,,,**************,,******,,,,**,,,*,,,,*******************************//*///****//*/*/(##%#%%%%%%%%%%%#%%%%%###/****************************************************************
*********************,,,,***************,,,*****,,,,*******,,,,,,,,************************************/(//((((((#%%%%%%%%%%%%%%%%%%%###(***************************************************************
********************,,***************,,,,,,*****,,,,*,,,,,,,,,,,**********,****************************///(((######%%%%%%%%%%%%%%%%%#%###(**************************************************************
*******************,,***************,,,,,,,*****,,,*,,,,,,*,************,********************************(#((##((((((((((((((///(((##%%###/*************************************************************
******************,,**************,,,,,,,,,*****,,***,,,,,,,*********************,****,***************/**(#%##((####((((((((//(/////(#%%##**************************************************************
****,***********,,*******************,,,,,,*****,,*,,,,,,,,,************,**,*,,,***********************/(#%##(((####((((((((((//////((###(**************************************************************
*,,,,********************************,,,,,******,,,,,,,,****************,,***********,,*,,,,***********((###((########((((((((//////((###(**************************************************************
,,*,,,**********************,******,,,,,,,*****,,*,,,,*****************,,,,,,,,,,**,,,,*,*************//(##(((#####((####(((###((((//(###/**************************************************************
,*,,,********************************,,,,,*****,,,**************************,,,,,**,*,**,*************//(///((##(((((####((((#%#((((((##/***************************************************************
,,,,,,*******,,,,**,,,*****************,,,********************************************,*,**********/((#((*///(#(((((#####(((((((/((((#/*****************************************************************
,,,,*,*,*,,*,,,,,***,*****,,,,,******************************,,,,***********,,,,**,*****************/###((/(((###########((((/(////(((******************************************************************
,,,,,,,,,,,,,*,,,,,,,,,,,,,,,,,,,*******,****************,,,,***,,************,,*********************/(((#(((((#########((((((((/((((((*****************************************************************
,,,,,,**,,,,,,,,,,,,,,,,,,,,,,,,,,********************,,,,,,,,,,,,,,***********************************//(((((((######((((/((((((((((/******************************************************************
,,*,,**,*****,,,,,,,,,,,,,,,,,,,,********************,,,,,,,,,,,,,,,*************************************/((((((###%%%%%#%%#(((((((//*******************************************************************
,,,,**,,,,,,,,,,,,,,,,,,,,,,,,,,,,******************,,,,,,,,,,,,,,,,,************************,***,********/(((((((####(#(((((((((***********************************************************************
,,,,,*,,,,,,,,,,,,,,,,,,,,,,,,,,,,,,,***********,*,,,,,,,,,*,*,,,,,,,,,**********************************/((((((((((((((((((((((************************************************************************
,,,,,,,,,,,,,,,,,,,,,,,,,,,,,,,,,,,*,*********,,,,*,,,,***,,,***,,,,****,,*******************************/((((######((((((((((((************************************************************************
,,*,**,**,,,,,*,,****,**,,,,*,,,,************************************************************************/((#(#(########((((((((##/*********************************************************************
*****,,,,,,,,,,,,,,,,,,,,,,,,,,,,,,***********************************************************//********//((###(####((((((((((((*%%%#/******************************************************************
***,,,,,,,,,,,,,,,,,,,,,,,,,,,,,,************,,,,,,,,,,,,,,,,*,,,,,,*,,,,****************************/**//(/****/*(#(((((((((((/*#%%%%%#(((///**********************************************************
****,,,,,,,,,,,,,,,,,,,,,,,,****************,,,,,,,,,,,,,,,,,**,,,,***,,***********************///////*//((((((#((####((((((((/**%%%%%%%%######((((((//*************************************************
***,,,*****,,,,,,,,,,,,,,,*******************,,,,,,,,,*,,,,,**,,,,,***********************///((####((*///(((((((((#####(((##//***%%%%%&&&&&%%%%#%%#########((//*****************************************
***********,,,,,,,,,,,,,,,*****************,,,,,,,,,,,,,,,,,,,,,,,,*,,,,**************///(##%%%%%%%#(*///#(#((((((#######(///**//%%%%%&&&&&&&%%%%%%%%%%%%%%%%%%%%%(*************************************
****,***,*,,,,,,,,,,,,**,,**,**************,,,,,,,,,,*,,,,,,,,,,,,**,***********////((##%%&%%&&%%%%%(*///###(((#((#####(///****(%%%%%%&&&&&&&&&%%%%%%&&&&&&&%%%%%%%#************************************
*********,,,,,,,,,,***********************,,,,*,,,,,,,,,,,,,*,,,,,**,*********(((###%%%%%&&&&&&%%%%%/*//(##((#((((#(//////*///%%%%%%%%&&&&&&&&&&%%%&&&&%%%%%%%%%%%%%#***********************************
************,,,,,,*************************,,*****,***,*,,*******************/%%%%%%%%%%%&&&&&&&%%%%(////(///***////////////#%%%%%%%&&&&&&&&&&&&&&&&&&%%%%%&%%%%%%%%%/**********************************
,,,**********,,**************************,,,,*,,,,,,*,,,,,,*,,,,,************(%%%%%%%%%&&&&&&&&&&%%%%%%%####((%%%%%%%%#(//(##%%%&&&&&&&&&&&&&&&&&&&&&&%%%%&%%%&&&%%%%#**********************************
,,,*************************,,****************,*,****************************#%%%%%%%%%&&&&&&&&&&&&%%%%%&%#//**####((((/(/(/(#%%%&&&&&&&&&&&&&%#((%&%%%%%%%&&&%%%%%%%(**********************************
*,,************************,,,**********,,,,*,,,,,,*,,,,,,******************/%%%%%%%%%%&&&&&&&&&&&&%%&%%##(///////////(((##%%%%%%&&&&&&&&&&&&&%###(#%%%&&&%%%&%%%%%%#***********************************
,,,,*******************,,,,,************,,,**,,,,,**,*,*********************/%%%%%%%%%%&&&&&&%&&&&&%%&%%#((////(((###%%&&&&&&&%%%&&&&&&&&&&&&&%####(%&&&%%%%%&&&%%%(************************************
,,,,******************,,,,,,,**********,,,,*,,,,,****,,,********************/%%%%%%&%&&&&&&&&&%&&&&%&&&%%%#////%%&&&%%%%%####%%%%&&&&&&&&&&&&&&&###(#&%%%#((//(%%%%/************************************
**,,,,************,,,,,,,,,,***********,,,**,,,,,,*,**,**********************#%%%%&&&&&&&&&&&&&&&&%&&&&%%%#/**/###(((((((((((%%%&&&&&&&&&&&&&&&&###((##((//((##%%%%(************************************
*,,,*************,,,,,,,,,,************,,*****,,,***,,,**********************(%%%%&&&&&&&&&&&&&&&&&&&&&%%#((#((((((((((###%%&&%%&&&&&&&&&&&&&&&&######(((((##%%%%%/*************************************
***,,,**********,,,*******************,,,**,*********************************/%%%%&&&&&&&&&&&&&&&&&&&&&&&%#(##%%%%%&&&&&&&&&&&%&&&&&&&&&&&&&&&&&########((/((%%%%%#/************************************
,,,**********,,,,,,,,,,,,,***************************************************/%%%%%&&&&&&&&&&&&&&&&&&&&&&&&###%%%%%%###((((((#%%&&&&&&&&&&&&&&&&%###(((((###(#%%%%%%%/**********************************
,************,,,,,,,,,,,,**************,*************************************(%%%%%&&&&&&&&&&&&&&&&&&&&&&%#(##(((((((((((((###%%&&&&&&&&&&&&&&&&&#####(((/((#%%%%%%%%%#/********************************
**************,,,,,**,,,,*****************,**********************************(%%%%%&&&&&&&&&&&&&&&&&&&&&&&#((#(####%%%%&&&&&&&&&&&&&&&&&&&&&&&######((/(((((#%%&&&&%%%%#/*******************************
*******************,*********************************************************/%%%%%&&&&&&&&&&&&&&&&&&&&&&&&#(%&&&&&&%%%%###(##%%%&&&&&&&&&&&&&&##(((((/(((((#%%%%%%%%%%%#/******************************
******************,,,********************************************************/#%%%%&&&&&&&&&&&&&&&&&&&&&&&%((%###(((((((((##%%%%%%&&&&&&&&&&&&&&&%%#(###(#((#%%%%%%%%&%%%#/*****************************
******************************************************************************(%%%&&&&&&&&&&&&&&&&&&&&&&&&%((#((((((###%%%&&&&&%###%&&&&&&&&&&&&&&&&%%%####%&&%%%%%%%%%%%%%/****************************
******************,,,,*******************************************************//%%&&&&&&&&&&&&&&&&&&&&&&&&&%(#%%%%&&&&&&&&%%%%%%%%%##%&&&&&&&&&&&&&&&&%&&%%%%&&&%%%%%%%%%%%%#/***************************
*******************,,**************,,*****************************************(%%&&&&&&&&&&&&&&&&&&&&&&&&&%(#%&&&%%%%####(((((((#####%&&&&&&&&&&&&&&&&&&&%%&&&&&%%%%%%%%%%%%/***************************
********************************,*******************************************//(%&&&&&&&&&&&&&&&&&&&&&&&&&&%###(((((((((((#######%%%%%%%&&&&&&&&&&&&&&&&&&%%%&&&&&%%%%%%%%%%%%//*************************
********************************,********************************************/#%&&&&&&&&&&&&&&&&&&&&&&&&&&%(###(#####%%%&&&&&&&&&&&&&&&%&&&&&&&&&&&&&&&&&&&%&&&&%%##%%%%%%%%(*/*************************
